#################################
#                               #
#     #     #       #           #
#      #   #        #           #
#        #      @   #           #
#        #          #           #
#        #          ######      #
#                               #
#################################